8 8 8 6 6 6 8 8 8 8 6 6 6 8 8 8
8 5 6 4 4 4 6 3 8 5 4 4 4 6 3 8
8 9 4 4 8 4 4 7 8 9 4 4 8 4 7 8
6 4 4 5 12 3 4 4 6 4 4 5 12 3 4 6
4 4 7 8 8 9 4 4 4 4 7 8 8 9 4 4
4 5 3 8 8 9 4 5 4 3 9 8 8 5 3 4
4 4 6 4 4 4 6 4 4 4 6 4 4 4 6 4
6 4 4 4 5 6 4 4 6 4 4 4 5 6 4 6
8 9 4 5 12 12 4 3 8 5 4 5 12 12 4 7
8 9 4 4 4 4 4 7 8 9 4 4 4 4 4 7
8 5 12 12 12 12 12 3 8 5 12 12 12 12 12 3
8 8 8 8 8 8 8 8 8 8 8 8 8 8 8 8