32 32 32 32 32 32 32 32 32 32 32 32 32 32 32 32 32 32 32 32 32 32 32 17 16 16 16 18 32 32 32 32 32 32 32 32 32 32 32 32 32 32 32 32 32 32 32 20 15 13
32 32 32 32 32 32 32 32 32 32 32 32 32 32 32 32 32 32 32 32 32 32 32 17 16 16 16 18 32 32 32 32 32 32 32 32 32 32 32 32 32 32 32 32 32 32 32 20 15 13
32 32 11 28 29 29 29 29 29 29 29 29 29 29 29 29 29 29 29 29 29 11 32 17 16 16 16 18 32 32 32 32 32 32 32 32 32 32 32 32 32 32 32 32 32 32 32 20 15 13
32 32 11 27 28 29 29 29 29 29 29 25 25 29 29 29 29 29 29 29 29 11 32 21 16 16 16 22 25 25 25 25 25 25 25 25 25 25 25 25 25 25 25 25 32 32 32 20 15 13
32 32 11 27 27 28 29 29 29 29 29 25 25 29 29 29 29 29 29 29 29 11 32 21 16 16 16 22 25 25 34 34 34 34 34 34 34 34 34 34 34 25 25 25 34 34 34 34 15 13
32 32 11 27 27 27 28 29 29 29 29 25 25 29 29 29 29 29 29 29 29 11 32 21 16 16 16 22 25 25 32 32 32 32 32 32 32 32 34 34 34 25 25 25 34 34 34 34 15 13
32 32 11 27 27 27 27 26 26 26 26 25 25 26 26 26 26 26 26 26 26 11 32 21 16 16 16 22 25 25 32 32 32 32 32 32 32 32 34 35 35 35 25 35 35 35 32 32 15 13
32 32 11 27 27 27 27 26 26 26 26 25 25 26 26 26 26 26 26 26 26 11 32 21 16 16 16 22 25 25 32 32 32 32 32 32 32 32 34 35 35 35 25 35 35 35 32 32 15 13
32 32 11 27 27 27 27 26 26 26 26 25 25 26 26 26 26 26 26 26 26 11 32 21 16 16 16 22 25 25 32 32 32 32 32 32 32 32 34 35 35 35 25 35 35 35 32 32 15 13
32 32 11 27 27 27 27 26 26 26 26 25 25 26 26 26 26 26 26 26 26 11 32 21 16 16 16 22 25 25 32 32 32 32 32 32 32 32 34 35 35 35 25 35 35 35 32 32 15 13
32 32 11 27 27 27 27 26 26 26 26 25 25 26 26 26 26 26 26 26 26 11 32 21 16 16 16 22 25 25 32 32 32 32 32 32 32 32 34 35 35 35 25 25 25 25 25 25 15 13
32 32 11 27 27 27 27 26 26 26 26 25 25 29 29 29 29 29 23 24 29 11 32 21 16 16 16 22 25 25 32 32 32 32 32 32 32 32 34 35 35 35 25 35 35 35 32 32 15 13
32 32 11 27 27 27 27 26 26 26 26 25 25 29 29 29 29 29 23 24 29 11 32 21 16 16 16 22 25 25 32 32 32 32 32 32 32 32 34 35 35 35 25 35 35 35 32 32 15 13
32 32 11 27 27 27 27 26 26 26 26 25 25 29 29 29 29 29 29 29 29 11 32 21 16 16 16 22 25 25 32 32 32 32 32 32 32 32 34 35 35 35 25 35 35 35 32 32 15 13
32 32 11 27 27 27 27 26 26 26 26 25 25 26 26 26 26 26 26 26 26 11 32 21 16 16 16 22 25 25 32 32 32 32 32 32 32 32 34 35 35 35 25 35 35 35 32 32 15 13
32 32 11 27 27 27 27 26 26 26 26 25 25 29 23 24 29 29 29 29 29 11 32 21 16 16 16 22 25 25 32 32 32 32 32 32 32 32 34 34 34 34 34 34 34 34 34 34 15 13
32 32 11 27 27 27 27 26 26 26 26 25 25 29 23 24 29 29 29 29 29 11 32 21 16 16 16 22 25 25 32 32 32 32 32 32 32 32 32 32 32 32 32 32 32 32 32 34 15 13
32 32 11 27 27 27 27 26 26 26 26 25 25 29 29 29 29 29 29 29 29 11 32 21 16 16 16 22 25 25 32 32 32 32 32 32 32 32 32 32 32 32 32 32 32 32 32 34 15 13
32 32 11 27 27 27 27 26 26 26 26 25 25 26 26 26 26 26 26 26 26 11 32 21 16 16 16 22 25 25 32 32 32 32 32 32 32 32 32 32 32 32 32 32 32 32 32 34 15 13
32 32 11 27 27 27 27 26 26 26 26 25 25 26 26 26 26 26 26 26 26 11 32 21 16 16 16 22 25 25 32 32 32 32 32 32 32 32 32 32 32 32 32 32 32 32 32 34 15 13
32 32 11 27 27 27 27 26 26 26 26 25 25 26 26 26 26 26 26 26 26 11 32 21 16 16 16 22 25 25 32 32 32 32 32 32 32 32 32 32 32 32 32 32 32 32 32 34 15 13
32 32 11 27 27 27 27 26 26 26 26 25 25 29 29 29 23 24 29 29 29 11 32 21 16 16 16 22 25 25 32 32 32 32 32 32 32 32 32 32 32 32 32 32 32 32 32 34 15 13
32 32 11 27 27 27 27 26 26 26 26 25 25 29 29 29 23 24 29 29 29 11 32 21 16 16 16 22 25 25 34 34 34 34 34 34 34 34 34 34 34 34 34 34 34 25 25 34 15 13
20 25 25 25 25 25 25 25 25 25 25 25 25 25 25 25 25 25 25 25 25 25 25 33 33 33 33 33 25 25 25 25 25 25 25 25 25 25 25 25 25 25 25 25 25 25 25 20 33 33
20 25 25 25 25 25 25 25 25 25 25 25 25 25 25 25 25 25 25 25 25 25 25 33 33 33 33 33 25 25 25 25 25 25 25 25 25 25 25 25 25 25 25 25 25 25 25 20 33 33
34 34 34 34 34 34 34 34 34 34 34 25 25 34 34 34 34 34 34 34 34 32 32 21 16 16 16 22 32 32 11 11 11 11 11 11 11 11 11 11 11 11 11 11 11 25 25 20 15 13
34 32 32 32 32 32 32 32 32 32 32 25 25 32 32 32 32 32 32 32 34 32 32 21 16 16 16 22 32 32 32 32 32 32 32 32 32 32 32 32 32 32 32 32 11 25 25 20 15 13
34 32 32 32 32 32 32 32 32 32 32 25 25 32 32 32 32 32 32 32 34 32 32 33 33 33 33 33 32 32 32 32 32 32 32 32 32 32 32 32 32 32 32 32 11 25 25 20 15 13
34 32 32 32 32 32 32 32 32 32 32 25 25 32 32 32 32 32 32 32 34 32 32 33 33 33 33 33 32 32 32 32 32 32 32 32 32 32 32 32 32 32 32 32 11 25 25 20 15 13
34 32 32 32 32 32 32 32 32 32 32 25 25 32 32 32 32 32 32 32 34 32 32 21 16 16 16 22 32 32 32 32 32 32 32 32 32 32 32 32 32 32 32 32 11 25 25 20 15 13
34 25 25 25 25 25 25 25 25 25 25 25 25 25 25 25 25 25 25 25 34 32 32 21 16 16 16 22 32 32 32 32 32 32 32 32 32 32 32 32 32 32 32 32 11 25 25 20 15 13
34 25 25 25 25 25 25 25 25 25 25 25 25 25 25 25 25 25 25 25 34 32 32 19 19 19 19 19 32 32 32 32 32 32 32 32 32 32 32 32 32 32 32 32 11 25 25 20 15 13
34 32 32 32 32 32 32 32 32 32 32 25 25 32 32 32 32 32 32 32 34 32 32 19 13 19 19 19 32 32 32 32 32 32 32 32 32 32 32 32 32 32 32 32 11 25 25 20 15 13
34 32 32 32 32 32 32 32 32 32 32 25 25 32 32 32 32 32 32 32 34 32 32 19 19 19 19 19 32 32 32 32 32 32 32 32 32 32 32 32 32 32 32 32 11 25 25 20 15 13
34 32 32 32 32 32 32 32 32 32 32 25 25 32 32 32 32 32 32 32 34 32 32 32 32 32 32 32 32 32 32 32 32 32 32 32 32 32 32 32 32 32 32 32 11 25 25 20 15 13
34 32 32 32 32 32 32 32 32 32 32 25 25 32 32 32 32 32 32 32 34 32 32 32 32 32 32 32 32 32 32 32 32 32 32 32 32 32 32 32 32 32 32 32 11 25 25 20 15 13
34 32 32 32 32 32 32 32 32 32 32 25 25 32 32 32 32 32 32 32 34 32 32 32 32 32 32 32 32 32 32 32 32 32 34 25 25 25 25 25 25 25 25 25 25 25 25 20 15 13
34 34 34 34 34 34 34 34 34 34 34 34 34 34 34 34 34 34 34 34 34 32 32 32 32 32 32 32 32 32 32 32 32 32 34 23 24 25 25 25 25 25 25 25 25 25 25 20 20 20
15 15 15 15 15 15 15 20 20 20 11 11 11 11 11 11 11 11 11 11 11 11 11 11 11 11 11 11 11 11 11 11 11 11 20 20 20 34 30 30 31 31 31 31 30 30 30 30 30 30
15 15 15 15 15 15 15 15 20 20 20 26 26 26 26 26 26 26 26 26 26 26 26 26 26 26 26 26 26 26 26 26 26 20 20 20 15 34 36 30 31 31 31 31 30 30 30 30 30 36
15 15 15 15 15 15 15 15 15 20 20 20 26 26 26 26 26 26 26 26 26 26 26 26 26 26 26 26 26 26 26 26 20 20 20 15 15 34 36 30 31 31 31 31 30 30 30 30 30 36
15 15 15 15 15 15 15 15 15 15 20 20 20 26 26 26 26 26 26 26 26 26 26 26 26 26 26 26 26 26 26 20 20 20 15 15 15 34 36 30 31 31 31 31 30 30 30 30 30 36
15 15 15 15 15 15 15 15 15 15 15 20 20 20 20 20 20 20 20 20 20 20 20 20 20 20 20 20 20 20 20 20 20 15 15 15 15 34 36 30 31 31 31 31 30 30 30 30 30 36
36 15 15 15 15 15 15 15 15 15 15 15 20 20 20 20 20 20 20 20 20 20 20 20 20 20 20 20 20 20 20 15 15 15 15 15 36 34 36 30 31 31 31 31 30 30 30 30 30 36
36 36 15 15 15 15 15 15 15 15 15 15 15 20 20 20 20 20 20 20 20 20 20 20 20 20 20 20 20 20 15 15 15 15 15 36 36 34 36 30 31 31 31 31 30 30 30 30 30 36
36 36 36 15 15 15 15 15 15 15 15 15 15 15 15 15 15 15 15 15 15 15 15 15 15 15 15 15 15 15 15 15 15 15 36 36 36 34 36 30 31 31 31 31 30 30 30 30 30 36
36 36 36 36 15 15 15 15 15 15 15 15 15 15 15 15 15 15 15 15 15 15 15 15 15 15 15 15 15 15 15 15 15 36 36 36 36 34 36 30 31 31 31 31 30 30 30 30 30 36
36 36 36 36 36 15 15 15 15 15 15 15 15 15 15 15 15 15 15 15 15 15 15 15 15 15 15 15 15 15 15 15 36 36 36 36 36 34 36 30 31 31 31 31 30 30 30 30 30 36
36 36 36 36 36 36 13 13 13 13 13 13 13 13 13 13 13 13 13 13 13 13 13 13 13 13 13 13 13 13 13 36 36 36 36 36 36 34 36 30 31 31 31 31 30 30 30 30 30 36
36 36 36 36 36 36 36 36 36 36 36 36 36 36 36 36 36 36 36 36 36 36 36 36 36 36 36 36 36 36 36 36 36 36 36 36 36 34 36 36 36 36 36 36 36 36 36 36 36 36