8  8  8  8  8  8  8  8  8  8  8  8  8  8  8  8  8  8  8  8  8  8  8  8  8  8  8  8  8  8  8  8  8  8  8  8  8  8  8  8  8  8  8  8  8  8  8  8  8  8
8  8  8  8  8  8  8  8  8  8  10 10 10 10 10 10 10 10 10 10 10 10 10 10 10 10 10 10 10 10 10 8  8  8  8  8  8  8  8  8  8  8  8  8  8  8  8  8  8  8
8  8  8  8  8  8  8  8  8  8  10 8  8  8  8  8  8  8  8  8  8  8  8  8  8  8  8  8  8  8  10 8  8  8  8  8  8  8  8  8  8  8  8  8  8  8  8  8  8  8
8  8  8  8  8  8  8  8  8  8  10 8  8  8  8  8  8  8  8  8  8  8  8  8  8  8  8  8  8  8  10 8  8  8  8  8  8  8  8  8  8  8  8  8  8  8  8  8  8  8
8  8  8  8  8  8  8  8  8  8  10 8  8  8  8  8  8  8  8  8  8  8  8  8  8  8  8  8  8  8  10 8  8  8  8  8  8  8  8  8  8  8  8  8  8  8  8  8  8  8
8  8  8  8  8  8  8  8  8  8  10 8  8  8  8  8  8  8  8  8  8  8  8  8  8  8  8  8  8  8  10 8  8  8  8  8  8  8  8  8  8  8  8  8  8  8  8  8  8  8
8  8  8  8  8  8  8  8  8  8  10 8  8  8  8  8  8  8  8  8  8  8  8  8  8  8  8  8  8  8  10 8  8  8  8  8  8  8  8  8  8  8  8  8  8  8  8  8  8  8
8  8  8  8  8  8  8  8  8  8  10 8  8  8  8  8  8  8  8  8  8  8  8  8  8  8  8  8  8  8  10 8  8  8  8  8  8  8  8  8  8  8  8  8  8  8  8  8  8  8
8  8  8  8  8  8  8  8  8  8  10 8  8  8  8  8  8  8  8  8  8  8  8  8  8  8  8  8  8  8  10 8  8  8  8  8  8  8  8  8  8  8  8  8  8  8  8  8  8  8
8  8  8  8  8  8  8  8  8  8  10 8  8  8  8  8  8  8  8  8  8  8  8  8  8  8  8  8  8  8  10 8  8  8  8  8  8  8  8  8  8  8  8  8  8  8  8  8  8  8
8  8  8  8  6  6  6  6  6  6  10 8  8  8  8  8  8  8  8  8  8  8  8  8  8  8  8  8  8  8  10 8  8  8  8  8  8  8  8  8  8  8  8  8  8  8  8  8  8  8
8  8  8  8  4  4  4  4  4  4  10 10 10 10 10 4  4  4  4  4  4  4  4  4  4  4  10 10 10 10 10 8  8  8  8  8  8  8  8  8  8  8  8  8  8  8  8  8  8  8
8  8  8  8  4  4  4  4  4  4  4  4  4  4  4  4  4  4  4  4  4  4  4  4  4  4  4  4  4  4  4  4  4  4  4  4  4  4  4  4  4  4  4  4  4  4  8  8  8  8
8  8  8  8  4  4  4  4  4  4  4  4  4  4  4  4  4  4  4  4  4  4  4  4  4  4  4  4  4  4  4  4  4  4  4  4  4  4  4  4  4  4  4  4  4  4  8  8  8  8
8  8  8  8  12 12 12 12 12 12 4  4  4  4  4  12 12 12 12 12 12 12 12 12 12 12 4  4  4  4  4  4  4  4  4  4  4  4  4  4  4  4  4  4  12 12 8  8  8  8
8  8  8  8  8  8  8  8  8  8  4  4  4  4  4  8  8  8  8  8  8  8  8  8  8  8  4  4  4  4  4  8  8  8  8  8  8  8  8  8  8  8  8  8  8  8  8  8  8  8
8  8  8  8  8  8  8  8  8  8  4  4  4  4  4  8  8  8  8  8  8  8  8  8  8  8  4  4  4  4  4  8  8  8  8  8  8  8  8  8  8  8  8  8  8  8  8  8  8  8
8  8  8  8  8  8  8  8  8  8  4  4  4  4  4  8  8  8  8  8  8  8  8  8  8  8  4  4  4  4  4  8  8  8  8  8  8  8  8  8  8  8  8  8  8  8  8  8  8  8
11 11 11 11 11 11 11 11 11 11  11 11  11  11  11  11  11  11  11  11  11  11  11  11  11  11  11 11  11  11  11 11 11  11  11  11  11  11  11  11  11  11  11  11  11  11  11  11 11 11 11 11
11 11 11 11 11 11 11 11 11 11  11 11  11  11  11  11  11  11  11  11  11  11  11  11  11  11  11 11  11  11  11 11 11  11  11  11  11  11  11  11  11  11  11  11  11  11  11  11 11 11 11 11
13 13 13 13 13 13 13 13 13 13  13 13 13 13 13  13  13  13  13  13  13  13  13  13  13  13  13 13  13  13  13 13 13  13  13  13  13  13  13  13  13  13  13  13  13  13  13  13 13 13 13 13
13 13 13 13 13 13 13 13 13 13 13 13 13 13 13  13 13 13 13 13 13 13 13 13 13 13 13 13  13  13  13  13  13  13  13  13  13  13  13  13  13  13  13  13  13  13  13  13  13 13 13 13 13 13
13 13 13 13 13 13 13 13 13 13 13 13 13 13 13  13 13 13 13 13 13 13 13 13 13 13 13 13  13  13  13  13 13 13 13 13 13 13 13 13 13 13 13 13 13 13 13 13 13 13 13 13 13 13 13
13 13 13 13 13 13 13 13 13 13 13 13 13 13 13  13 13 13 13 13 13 13 13 13 13 13 13 13  13  13  13  13 13 13 13 13 13 13 13 13 13 13 13 13 13 13 13 13 13 13 13 13 13 13 13
13 13 13 13 13 13 13 13 13 13 13 13 13 13 13  13 13 13 13 13 13 13 13 13 13 13 13 13  13  13  13  13 13 13 13 13 13 13 13 13 13 13 13 13 13 13 13 13 13 13 13 13 13 13 13
13 13 13 13 13 13 13 13 13 13  13 13 13 13 13  13  13  13  13  13  13  13  13 13  13  13  13 13  13  13  13 13 13 13 13 13 13 13 13 13 13 13 13 13 13 13 13 13 13 13 13
13 13 13 13 13 13 13 13 13 13  13 13 13 13 13  13  13  13  13  13  13  13  13  13  13  13  13 13  13  13  13 13 13 13 13 13 13 13 13 13 13 13 13 13 13 13 13 13 13 13 13 13
13 13 13 13 13 13 13 13 13 13  13 13 13 13 13  13  13  13  13  13  13  13  13  13  13  13 13 13  13  13  13 13 13 13 13 13 13 13 13 13 13 13 13 13 13 13 13 13 13 13 13 13
11 11 11 11 11 11 11 11 11 11  11 11  11  11  11  11  11  11  11  11  11  11  11  11  11  11  11 11  11  11  11 11 11  11  11  11  11  11  11  11  11  11  11  11  11  11  11 11 11 11 11 11
11 11 11 11 11 11 11 11 11 11  11 11  11  11  11  11  11  11  11  11  11  11  11  11  11  11  11 11  11  11  11 11 11  11  11  11  11  11  11  11  11  11  11  11  11  11  11 11 11 11 11 11
8  8  8  8  8  8  8  8  8  8  4  4  4  4  4  8  8  8  8  8  8  8  8  8  8  8  4  4  4  4  4  8  8  8  8  8  8  8  8  8  8  8  8  8  8  8  8  8  8  8
8  8  8  8  8  8  8  8  8  8  4  4  4  4  4  8  8  8  8  8  8  8  8  8  8  8  4  4  4  4  4  8  8  8  8  8  8  8  8  8  8  8  8  8  8  8  8  8  8  8
8  8  10 10 10 10 10 10 10 10 4  4  4  4  4  10 10 10 10 10 10 10 10 10 10 10 4  4  4  4  4  10 10 10 10 10 10 10 10 10 10 10 10 10 10 10 8  8  8  8
8  8  10 8  8  8  8  8  8  8  4  4  4  4  4  8  8  8  8  8  8  8  8  8  8  10 4  4  4  4  4  8  8  8  8  8  8  8  8  8  8  8  8  8  8  10 8  8  8  8
8  8  10 8  10 10 8  8  8  8  4  4  4  4  4  8  8  8  8  8  8  8  8  8  8  10 4  4  4  4  4  8  8  8  8  8  8  8  8  8  8  10 10 10 10 10 8  8  8  8
8  8  10 8  10 10 8  8  8  8  4  4  4  4  4  8  8  8  8  8  8  8  8  8  8  10 4  4  4  4  4  8  8  8  8  8  8  8  8  8  8  10 8  8  8  8  8  8  8  8
8  8  10 8  8  8  8  8  8  8  4  4  4  4  4  8  8  8  8  8  8  8  8  8  8  10 4  4  4  4  4  8  8  8  8  8  8  8  8  8  8  10 8  8  8  8  8  8  8  8
8  8  10 8  8  8  8  8  8  8  4  4  4  4  4  8  8  8  8  8  8  8  8  8  8  10 4  4  4  4  4  8  8  8  8  8  8  8  8  8  8  10 8  8  8  8  8  8  8  8
8  8  10 8  8  8  8  8  8  8  4  4  4  4  4  8  8  8  8  8  8  8  8  8  8  10 4  4  4  4  4  8  8  8  8  8  8  8  8  8  8  10 8  8  8  8  8  8  8  8
8  8  10 8  8  8  8  8  8  8  4  4  4  4  4  8  8  8  8  8  8  8  8  8  8  10 4  4  4  4  4  8  8  8  8  8  8  4  4  4  4  4  4  4  4  8  8  8  8  8
8  8  10 8  10 10 8  8  8  8  4  4  4  4  4  8  8  8  8  8  8  8  8  8  8  10 4  4  4  4  4  8  8  8  8  8  8  4  4  4  4  4  4  4  4  8  8  8  8  8
8  8  10 8  10 10 8  8  8  8  4  4  4  4  4  8  8  8  8  8  8  8  8  8  8  10 4  4  4  4  4  8  8  8  8  8  8  4  4  4  4  10 8  8  8  8  8  8  8  8
8  8  10 8  8  8  8  8  8  8  4  4  4  4  4  8  8  8  8  8  8  8  8  8  8  10 4  4  4  4  4  8  8  8  8  8  8  4  4  4  4  10 8  8  8  8  8  8  8  8
8  8  10 10 10 10 10 10 10 10 4  4  4  4  4  10 10 10 10 10 10 10 10 10 10 10 4  4  4  4  4  8  8  8  8  8  8  4  4  4  4  10 8  8  8  8  8  8  8  8
6  6  6  6  6  6  6  6  6  6  4  4  4  4  4  6  6  6  6  6  6  6  6  6  6  6  4  4  4  4  4  8  8  8  8  8  8  4  4  4  4  10 10 10 10 10 8  8  8  8
4  4  4  4  4  4  4  4  4  4  4  4  4  4  4  4  4  4  4  4  4  4  4  4  4  4  4  4  4  4  4  8  8  8  8  8  8  4  4  4  4  4  4  4  4  10 8  8  8  8
4  4  4  4  4  4  4  4  4  4  4  4  4  4  4  4  4  4  4  4  4  4  4  4  4  4  4  4  4  4  4  8  8  8  8  8  8  4  4  4  4  4  4  4  4  10 8  8  8  8
4  4  4  4  4  4  4  4  4  4  4  4  4  4  4  4  4  4  4  4  4  4  4  4  4  4  4  4  4  4  4  8  8  8  8  8  8  12 12 12 12 12 12 12 12 10 8  8  8  8
12 12 12 12 12 12 12 12 12 12 12 12 12 12 12 12 12 12 12 12 12 12 12 12 12 12 12 12 12 12 12 8  8  8  8  8  8  8  8  8  8  8  8  8  8  8  8  8  8  8
8  8  8  8  8  8  8  8  8  8  8  8  8  8  8  8  8  8  8  8  8  8  8  8  8  8  8  8  8  8  8  8  8  8  8  8  8  8  8  8  8  8  8  8  8  8  8  8  8  8