32 32 32 32 32 32 32 32 32 32 32 32 32 32 32 32 32 32 32 32 32 32 32 17 16 16 16 18 32 32 32 32 32 32 32 32 32 32 32 32 32 32 32 32 32 32 32 20 32 36
32 32 32 32 32 32 32 32 32 32 32 32 32 32 32 32 32 32 32 32 32 32 32 17 16 16 16 18 32 32 32 32 32 32 32 32 32 32 32 32 32 32 32 32 32 32 32 20 32 36
32 32 11 28 29 29 29 29 29 29 29 29 29 29 29 29 29 29 29 29 29 11 32 17 16 16 16 18 32 32 32 32 32 32 32 32 32 32 32 32 32 32 32 32 32 32 32 20 32 36
32 32 11 27 28 29 29 29 29 29 29 25 25 29 29 29 29 29 29 29 29 11 32 21 16 16 16 22 25 25 25 25 25 25 25 25 25 25 25 25 25 25 25 25 25 25 25 20 32 36
32 32 11 27 27 28 29 29 29 29 29 25 25 29 29 29 29 29 29 29 29 11 32 21 16 16 16 22 25 25 32 32 32 32 32 32 32 32 32 32 32 25 25 25 32 32 32 32 32 36
32 32 11 27 27 27 28 29 29 29 29 25 25 29 29 29 29 29 29 29 29 11 32 21 16 16 16 22 25 25 32 32 32 32 32 32 32 32 32 32 32 25 25 25 32 32 32 32 32 36
32 32 11 27 27 27 27 26 26 26 26 25 25 26 26 26 26 26 26 26 26 11 32 21 16 16 16 22 25 25 32 32 32 32 32 32 32 32 32 35 35 35 25 35 35 35 32 32 32 36
32 32 11 27 27 27 27 26 26 26 26 25 25 26 26 26 26 26 26 26 26 11 32 21 16 16 16 22 25 25 32 32 32 32 32 32 32 32 32 35 35 35 25 35 35 35 32 32 32 36
32 32 11 27 27 27 27 26 26 26 26 25 25 26 26 26 26 26 26 26 26 11 32 21 16 16 16 22 25 25 32 32 32 32 32 32 32 32 32 35 35 35 25 35 35 35 32 32 32 36
32 32 11 27 27 27 27 26 26 26 26 25 25 26 26 26 26 26 26 26 26 11 32 21 16 16 16 22 25 25 32 32 32 32 32 32 32 32 32 35 35 35 25 35 35 35 32 32 32 36
32 32 11 27 27 27 27 26 26 26 26 25 25 26 26 26 26 26 26 26 26 11 32 21 16 16 16 22 25 25 32 32 32 32 32 32 32 32 32 35 35 35 25 25 25 25 25 25 32 36
32 32 11 27 27 27 27 26 26 26 26 25 25 29 29 29 29 29 23 24 29 11 32 21 16 16 16 22 25 25 32 32 32 32 32 32 32 32 32 35 35 35 25 35 35 35 32 32 32 36
32 32 11 27 27 27 27 26 26 26 26 25 25 29 29 29 29 29 23 24 29 11 32 21 16 16 16 22 25 25 32 32 32 32 32 32 32 32 32 35 35 35 25 35 35 35 32 32 32 36
32 32 11 27 27 27 27 26 26 26 26 25 25 29 29 29 29 29 29 29 29 11 32 21 16 16 16 22 25 25 32 32 32 32 32 32 32 32 32 35 35 35 25 35 35 35 32 32 32 36
32 32 11 27 27 27 27 26 26 26 26 25 25 26 26 26 26 26 26 26 26 11 32 21 16 16 16 22 25 25 32 32 32 32 32 32 32 32 32 35 35 35 25 35 35 35 32 32 32 36
32 32 11 27 27 27 27 26 26 26 26 25 25 29 23 24 29 29 29 29 29 11 32 21 16 16 16 22 25 25 32 32 32 32 32 32 32 32 32 32 32 32 32 32 32 32 32 32 32 36
32 32 11 27 27 27 27 26 26 26 26 25 25 29 23 24 29 29 29 29 29 11 32 21 16 16 16 22 25 25 32 32 32 32 32 32 32 32 32 32 32 32 32 32 32 32 32 32 32 36
32 32 11 27 27 27 27 26 26 26 26 25 25 29 29 29 29 29 29 29 29 11 32 21 16 16 16 22 25 25 32 32 32 32 32 32 32 32 32 32 32 32 32 32 32 32 32 32 32 36
32 32 11 27 27 27 27 26 26 26 26 25 25 26 26 26 26 26 26 26 26 11 32 21 16 16 16 22 25 25 32 32 32 32 32 32 32 32 32 32 32 32 32 32 32 32 32 32 32 36
32 32 11 27 27 27 27 26 26 26 26 25 25 26 26 26 26 26 26 26 26 11 32 21 16 16 16 22 25 25 32 32 32 32 32 32 32 32 32 32 32 32 32 32 32 32 32 32 32 36
32 32 11 27 27 27 27 26 26 26 26 25 25 26 26 26 26 26 26 26 26 11 32 21 16 16 16 22 25 25 32 32 32 32 32 32 32 32 32 32 32 32 32 32 32 32 32 32 32 36
32 32 11 27 27 27 27 26 26 26 26 25 25 29 29 29 23 24 29 29 29 11 32 21 16 16 16 22 25 25 32 32 32 32 32 32 32 32 32 32 32 32 32 32 32 32 32 32 32 36
32 32 11 27 27 27 27 26 26 26 26 25 25 29 29 29 23 24 29 29 29 11 32 21 16 16 16 22 25 25 32 32 32 32 32 32 32 32 32 32 32 32 32 32 32 25 25 32 32 36
20 25 25 25 25 25 25 25 25 25 25 25 25 25 25 25 25 25 25 25 25 25 25 33 33 33 33 33 25 25 25 25 25 25 25 25 25 25 25 25 25 25 25 25 25 25 25 25 33 33
20 25 25 25 25 25 25 25 25 25 25 25 25 25 25 25 25 25 25 25 25 25 25 33 33 33 33 33 25 25 25 25 25 25 25 25 25 25 25 25 25 25 25 25 25 25 25 25 33 33
32 32 32 32 32 32 32 32 32 32 32 25 25 32 32 32 32 32 32 32 32 32 32 21 16 16 16 22 32 32 32 32 32 32 32 32 32 32 32 32 32 32 32 32 32 25 25 32 32 36
32 32 32 32 32 32 32 32 32 32 32 25 25 32 32 32 32 32 32 32 32 32 32 21 16 16 16 22 32 32 32 32 32 32 32 32 32 32 32 32 32 32 32 32 32 25 25 32 32 36
32 32 32 32 32 32 32 32 32 32 32 25 25 32 32 32 32 32 32 32 32 32 32 33 33 33 33 33 32 32 32 32 32 32 32 32 32 32 32 32 32 32 32 32 32 25 25 32 32 36
32 32 32 32 32 32 32 32 32 32 32 25 25 32 32 32 32 32 32 32 32 32 32 33 33 33 33 33 32 32 32 32 32 32 32 32 32 32 32 32 32 32 32 32 32 25 25 32 32 36
32 32 32 32 32 32 32 32 32 32 32 25 25 32 32 32 32 32 32 32 32 32 32 21 16 16 16 22 32 32 32 32 32 32 32 32 32 32 32 32 32 32 32 32 32 25 25 32 32 36
32 25 25 25 25 25 25 25 25 25 25 25 25 25 25 25 25 25 25 25 32 32 32 21 16 16 16 22 32 32 32 32 32 32 32 32 32 32 32 32 32 32 32 32 32 25 25 32 32 36
32 25 25 25 25 25 25 25 25 25 25 25 25 25 25 25 25 25 25 25 32 32 32 19 19 19 19 19 32 32 32 32 32 32 32 32 32 32 32 32 32 32 32 32 32 25 25 32 32 36
32 32 32 32 32 32 32 32 32 32 32 25 25 32 32 32 32 32 32 32 32 32 32 19 19 19 19 19 32 32 32 32 32 32 32 32 32 32 32 32 32 32 32 32 32 25 25 32 32 36
32 32 32 32 32 32 32 32 32 32 32 25 25 32 32 32 32 32 32 32 32 32 32 19 19 19 19 19 32 32 32 32 32 32 32 32 32 32 32 32 32 32 32 32 32 25 25 32 32 36
32 32 32 32 32 32 32 32 32 32 32 25 25 32 32 32 32 32 32 32 32 32 32 32 32 32 32 32 32 32 32 32 32 32 32 32 32 32 32 32 32 32 32 32 32 25 25 32 32 36
32 32 32 32 32 32 32 32 32 32 32 25 25 32 32 32 32 32 32 32 32 32 32 32 32 32 32 32 32 32 32 32 32 32 32 32 32 32 32 32 32 32 32 32 32 25 25 32 32 36
32 32 32 32 32 32 32 32 32 32 32 25 25 32 32 32 32 32 32 32 32 32 32 32 32 32 32 32 32 32 32 25 25 25 25 25 25 25 25 25 25 25 25 25 25 25 25 32 32 36
32 32 32 32 32 32 32 32 32 32 32 32 32 32 32 32 32 32 32 32 32 32 32 32 32 32 32 32 32 32 32 25 25 25 25 25 25 25 25 25 25 25 25 25 25 25 25 32 32 36
26 26 26 26 26 26 26 26 26 26 26 26 26 26 26 26 26 26 26 26 26 26 26 26 26 26 26 26 26 26 26 23 24 26 26 26 26 26 30 30 31 31 31 31 31 31 30 30 30 30
26 26 26 26 26 26 26 26 26 26 26 26 26 26 26 26 26 26 26 26 26 26 26 26 26 26 26 26 26 26 26 23 24 26 26 26 26 26 30 30 31 31 31 31 31 31 30 30 30 30
26 26 26 26 26 26 26 26 26 26 26 26 26 26 26 26 26 26 26 26 26 26 26 26 26 26 26 26 26 26 26 26 26 26 26 26 26 26 30 30 31 31 31 31 31 31 30 30 30 30
26 26 26 26 26 26 26 26 26 26 26 26 26 26 26 26 26 26 26 26 26 26 26 26 26 26 26 26 26 26 26 26 26 26 26 26 26 26 30 30 31 31 31 31 31 31 30 30 30 30
26 26 26 26 26 26 26 26 26 26 26 26 26 26 26 26 26 26 26 26 26 26 26 26 26 26 26 26 26 26 26 26 26 26 26 26 26 26 30 30 31 31 31 31 31 31 30 30 30 30
40 40 40 40 40 40 40 40 40 40 40 40 40 40 40 40 40 40 40 40 40 40 40 40 40 40 40 40 40 40 40 40 40 40 40 40 40 40 30 30 31 31 31 31 31 31 30 30 30 30
40 40 40 40 40 40 40 40 40 40 40 40 40 40 40 40 40 40 40 40 40 40 40 40 40 40 40 40 40 40 40 40 40 40 40 40 40 40 30 30 31 31 31 31 31 31 30 30 30 30
40 40 40 40 40 40 40 40 40 40 40 40 40 40 40 40 40 40 40 40 40 40 40 40 40 40 40 40 40 40 40 40 40 40 40 40 40 40 30 30 31 31 31 31 31 31 30 30 30 30
40 40 40 40 40 40 40 40 40 40 40 40 40 40 40 40 40 40 40 40 40 40 40 40 40 40 40 40 40 40 40 40 40 40 40 40 40 40 30 30 31 31 31 31 31 31 30 30 30 30
40 40 40 40 40 40 40 40 40 40 40 40 40 40 40 40 40 40 40 40 40 40 40 40 40 40 40 40 40 40 40 40 40 40 40 40 40 40 30 30 31 31 31 31 31 31 30 30 30 30
40 40 40 40 40 40 40 40 40 40 40 40 40 40 40 40 40 40 40 40 40 40 40 40 40 40 40 40 40 40 40 40 40 40 40 40 40 40 30 30 31 31 31 31 31 31 30 30 30 30
40 40 40 40 40 40 40 40 40 40 40 40 40 40 40 40 40 40 40 40 40 40 40 40 40 40 40 40 40 40 40 40 40 40 40 40 40 40 30 30 31 31 31 31 31 31 30 30 30 30